1111111
1......1
1......1
1...b..1
1......1
1p...t.1
1111111