11111111
1......1
1......1
1...b..1
1......1
1p.....1
11111111