1111111
11   b1
1t1   1
1.11111
1.11111
1p....1
1111111