1111111111111111111111111111111111111
1b.1...11111...1..1.....1.....1.....1
1.1111.11111.1111.1.1.11111111111.1.1
1....1...1t..1....1.1.....1.1.....1.1
1.1..1.11111.1..1.1.11111.1.1.11111.1
1.1......1......1.1...1.........1...1
1.111111.1.111111.111.11111.11111.111
1...1.........1...1...1.........1...1
1.1.1.111.111.1.1.1.1.1.111.111.1.1.1
1.1.....1.1.....1.p.1...111.111...1.1
1.1.1.111.111.1.1.1.1.1.111.111.1.1.1
1...1.........1...1...1.........1...1
1.111111.1.111111.111.11111.11111.111
1.1......1......1.1...1...t.....1...1
1.1..1.11111.1..1.1.11111.1.1.11111.1
1....1...1...1....1.1.....1.1.....1.1
1.1111.11111.1111.1.1.11111111111.1.1
1..1...11111...1..1.....1.....1....b1
1111111111111111111111111111111111111