11111111111111111111111111111111111
1..........1...........1.........b1
1.111111111111111.111111111111111.1
1..............11.11..............1
11111111111111.11.11.11111111111111
1..........1...........1..........1
1.111111111111111.111111111111111.1
1......1...................1......1
1.1111111111111.111.1111111111111.1
1p..............111...............1--
1.1111111111111.111.1111111111111.1
1......1...................1......1
1.111111111111111.111111111111111.1
1..........1...........1..........1
11111111111111.11.11.11111111111111
1..............11.11..............1
1.111111111111111.111111111111111.1
1..........1...........1.........t1
11111111111111111111111111111111111