1111111111111111111111111111111111111
1b...1.......1....1........1.......b1
1.1.111.111.111.1.1.1.111.111.111.1.1
1.1...1.....1...1.1.1...1..t..1...1.1
1.1.1.111.111.1.1.111.1.111.111.1.111
1.1.1.1.....1.1.1.1.1.1.1.....1.1.1.1
1...1.1.111.1.1...1...1.1.111.1.1...1
1.1.1.1.....1.1.1.1.1.1.1..1..1.1.1.1
1.1.1.1111111.1.1.1.1.1....1....1.1.1
1.111.....t...111.p.1.1.1111111.111.1
1.1.1.1111111.1.1.1.1.1....1....1.1.1
1.1.1.1.....1.1.1.1.1.1.1..1..1.1.1.1
1...1.1.111.1.1...1...1.1.111.1.1...1
1.1.1.1.....1.1.1.1.1.1.1.....1.1.1.1
1.1.1.111.111.1.1.111.1.111.111.1.111
1.1...1.....1...1.1.1...1..t..1...1.1
1.1.111.111.111.1.1.1.111.111.111.1.1
1b...1...t...1....1........1.......b1
1111111111111111111111111111111111111